{ 
"cols" : 16, 
"rows" : 16, 
"terrain" : [ 
 [ 4, 4, 4, 4, 4, 4, 4, 4, 4, 4, 4, 4, 4, 4, 4, 4 ], 
 [ 4, 4, 4, 4, 4, 2, 2, 2, 4, 4, 4, 4, 4, 4, 4, 4 ], 
 [ 4, 4, 4, 2, 2, 1, 1, 1, 2, 4, 4, 4, 4, 4, 4, 4 ], 
 [ 4, 4, 2, 1, 1, 1, 1, 2, 4, 4, 4, 4, 2, 2, 4, 4 ], 
 [ 4, 2, 1, 1, 1, 1, 1, 2, 4, 4, 4, 2, 1, 1, 2, 4 ], 
 [ 4, 2, 1, 1, 1, 1, 2, 4, 4, 4, 2, 1, 1, 1, 2, 4 ], 
 [ 4, 2, 1, 1, 1, 1, 2, 4, 4, 2, 1, 1, 1, 1, 2, 4 ], 
 [ 4, 2, 1, 1, 1, 1, 1, 2, 2, 1, 1, 1, 1, 1, 2, 4 ], 
 [ 4, 4, 2, 1, 1, 1, 1, 1, 1, 1, 1, 1, 1, 1, 2, 4 ], 
 [ 4, 4, 2, 1, 1, 1, 3, 3, 3, 1, 1, 1, 1, 2, 4, 4 ], 
 [ 4, 4, 2, 1, 1, 3, 5, 5, 5, 3, 1, 1, 2, 4, 4, 4 ], 
 [ 4, 4, 4, 2, 1, 3, 5, 5, 5, 3, 1, 1, 2, 4, 4, 4 ], 
 [ 4, 4, 4, 4, 2, 3, 5, 5, 5, 3, 1, 2, 4, 4, 4, 4 ], 
 [ 4, 4, 4, 4, 2, 1, 3, 3, 3, 1, 2, 2, 4, 4, 4, 4 ], 
 [ 4, 4, 4, 4, 4, 2, 2, 2, 2, 2, 4, 4, 4, 4, 4, 4 ], 
 [ 4, 4, 4, 4, 4, 4, 4, 4, 4, 4, 4, 4, 4, 4, 4, 4 ] 
 ], 
"items" : [ 
 [ 0, 0, 0, 0, 0, 0, 0, 0, 0, 0, 0, 0, 0, 0, 0, 0 ], 
 [ 0, 0, 0, 0, 0, 0, 0, 0, 0, 0, 0, 0, 0, 0, 0, 0 ], 
 [ 0, 0, 0, 0, 0, 1, 1, 1, 0, 0, 0, 0, 0, 0, 0, 0 ], 
 [ 0, 0, 0, 1, 1, 1, 1, 0, 0, 0, 0, 0, 0, 0, 0, 0 ], 
 [ 0, 0, 1, 1, 1, 1, 1, 0, 0, 0, 0, 0, 2, 2, 0, 0 ], 
 [ 0, 0, 0, 1, 1, 0, 0, 3, 3, 0, 0, 0, 2, 2, 0, 0 ], 
 [ 0, 0, 0, 0, 0, 0, 0, 3, 3, 0, 0, 0, 0, 0, 0, 0 ], 
 [ 0, 0, 0, 0, 0, 0, 0, 0, 0, 0, 0, 0, 0, 0, 0, 0 ], 
 [ 0, 3, 0, 0, 0, 0, 0, 0, 0, 0, 0, 0, 0, 0, 0, 0 ], 
 [ 0, 3, 0, 0, 0, 0, 0, 0, 0, 0, 0, 0, 0, 0, 0, 0 ], 
 [ 0, 3, 0, 0, 0, 0, 0, 5, 0, 0, 0, 0, 0, 0, 0, 0 ], 
 [ 0, 0, 0, 0, 0, 0, 6, 4, 6, 0, 0, 0, 0, 0, 0, 0 ], 
 [ 0, 0, 0, 0, 0, 0, 0, 5, 0, 0, 0, 0, 3, 0, 0, 0 ], 
 [ 0, 0, 0, 0, 0, 0, 0, 0, 0, 0, 0, 0, 3, 0, 0, 0 ], 
 [ 0, 0, 0, 0, 0, 0, 0, 0, 0, 0, 0, 0, 0, 0, 0, 0 ], 
 [ 0, 0, 0, 0, 0, 0, 0, 0, 0, 0, 0, 0, 0, 0, 0, 0 ] 
 ], 
"resources" : [ 
 [ 0, 0, 0, 0, 0, 0, 0, 0, 0, 0, 0, 0, 0, 0, 0, 0 ], 
 [ 0, 0, 0, 0, 0, 0, 0, 0, 0, 0, 0, 0, 0, 0, 0, 0 ], 
 [ 0, 0, 0, 0, 0, 100, 100, 100, 0, 0, 0, 0, 0, 0, 0, 0 ], 
 [ 0, 0, 0, 100, 100, 100, 100, 0, 0, 0, 0, 0, 0, 0, 0, 0 ], 
 [ 0, 0, 100, 100, 100, 100, 100, 0, 0, 0, 0, 0, 100, 100, 0, 0 ], 
 [ 0, 0, 0, 100, 100, 0, 0, 100, 100, 0, 0, 0, 100, 100, 0, 0 ], 
 [ 0, 0, 0, 0, 0, 0, 0, 100, 100, 0, 0, 0, 0, 0, 0, 0 ], 
 [ 0, 0, 0, 0, 0, 0, 0, 0, 0, 0, 0, 0, 0, 0, 0, 0 ], 
 [ 0, 100, 0, 0, 0, 0, 0, 0, 0, 0, 0, 0, 0, 0, 0, 0 ], 
 [ 0, 100, 0, 0, 0, 0, 0, 0, 0, 0, 0, 0, 0, 0, 0, 0 ], 
 [ 0, 100, 0, 0, 0, 0, 0, 100, 0, 0, 0, 0, 0, 0, 0, 0 ], 
 [ 0, 0, 0, 0, 0, 0, 100, 100, 100, 0, 0, 0, 0, 0, 0, 0 ], 
 [ 0, 0, 0, 0, 0, 0, 0, 100, 0, 0, 0, 0, 100, 0, 0, 0 ], 
 [ 0, 0, 0, 0, 0, 0, 0, 0, 0, 0, 0, 0, 100, 0, 0, 0 ], 
 [ 0, 0, 0, 0, 0, 0, 0, 0, 0, 0, 0, 0, 0, 0, 0, 0 ], 
 [ 0, 0, 0, 0, 0, 0, 0, 0, 0, 0, 0, 0, 0, 0, 0, 0 ] 
 ] 
}
