03 03 03 03 03 03 03 03 03 03 03 03 03 03 03 03
03 03 03 03 03 01 01 01 03 03 03 03 03 03 03 03
03 03 03 01 01 00 00 00 01 03 03 03 03 03 03 03
03 03 01 00 00 00 00 01 03 03 03 03 01 01 03 03
03 01 00 00 00 00 00 01 03 03 03 01 00 00 01 03
03 01 00 00 00 00 01 03 03 03 01 00 00 00 01 03
03 01 00 00 00 00 01 03 03 01 00 00 00 00 01 03
03 01 00 00 00 00 00 01 01 00 00 00 00 00 01 03
03 03 01 00 00 00 00 00 00 00 00 00 00 00 01 03
03 03 01 00 00 00 02 02 02 00 00 00 00 01 03 03
03 03 01 00 00 02 04 04 04 02 00 00 01 03 03 03
03 03 03 01 00 02 04 04 04 02 00 00 01 03 03 03
03 03 03 03 01 02 04 04 04 02 00 01 03 03 03 03
03 03 03 03 01 00 02 02 02 00 01 01 03 03 03 03
03 03 03 03 03 01 01 01 01 01 03 03 03 03 03 03
03 03 03 03 03 03 03 03 03 03 03 03 03 03 03 03