03 03 03 03 03 03 03 03
03 03 01 01 01 01 03 03
03 01 02 02 02 02 01 03
03 01 04 00 04 04 01 03
03 01 04 04 04 00 01 03
03 01 02 02 02 02 01 03
03 03 01 01 01 01 03 03
03 03 03 03 03 03 03 03