03 03 03 03 03 03 03 03
03 01 01 01 01 01 01 03
03 01 00 04 00 00 01 03
03 01 00 04 04 04 01 03
03 01 04 04 04 00 01 03
03 01 00 00 04 00 01 03
03 01 01 01 01 01 01 03
03 03 03 03 03 03 03 03