00 00 00 00 03 03 00 00
00 03 00 00 00 00 00 00
03 00 00 04 00 00 00 03
03 00 02 01 02 02 00 03
00 00 02 02 02 01 00 00
00 00 00 00 00 00 00 00
03 03 00 00 00 00 03 00
00 00 00 00 00 03 00 00